5  5  5  5  5  5  5  5  5  5  5  5  5  5  5  5  5  5  5
5  5  5  5  5  5  5  5  5  5  5  5  5  5  5  5  5  5  5
5  5 -11 -11  5  5 -11 -11  5  5  5 -11 -11 -11 -11 -11  5  5  5
5  5 -11 -11  5  5 -11 -11  5  5  5  5  5  5  5 -11 -11  5  5
5  5 -11 -11  5  5 -11 -11  5  5  5  5  5  5  5 -11 -11  5  5
5  5 -11 -11 -11 -11 -11 -11  5  5  5  5 -11 -11 -11 -11  5  5  5
5  5  5 -11 -11 -11 -11 -11  5  5  5 -11 -11  5  5  5  5  5  5
5  5  5  5  5  5 -11 -11  5  5  5 -11 -11  5  5  5  5  5  5
5  5  5  5  5  5 -11 -11  5  5  5 -11 -11 -11 -11 -11 -11  5  5
5  5  5  5  5  5  5  5  5  5  5  5  5  5  5  5  5  5  5
5  5  5  5  5  5  5  5  5  5  5  5  5  5  5  5  5  5  5