0 0 0 0 0 0 0 0 0 0 0 0 0 0 0 0
0 0 0 0 0 0 0 0 0 0 0 0 0 0 0 0
0 0 0 0 0 7 7 5 5 7 7 0 0 0 0 0
0 0 0 0 0 7 8 8 8 8 7 0 0 0 0 0
0 0 0 0 0 7 8 9 9 8 7 0 0 0 0 0
0 0 0 0 0 7 5 5 5 5 7 0 0 0 0 0
0 0 0 0 0 7 8 9 9 8 7 0 0 0 0 0
0 0 0 0 0 7 8 9 9 8 7 0 0 0 0 0
0 0 0 0 0 7 8 9 9 8 7 0 0 0 0 0
0 0 0 0 0 7 8 9 9 8 7 0 0 0 0 0
0 0 0 0 0 7 8 9 9 8 7 0 0 0 0 0
0 0 0 0 0 7 8 9 9 8 7 0 0 0 0 0
0 0 7 7 7 7 7 7 7 7 7 7 7 7 0 0
0 0 7 8 8 8 8 6 6 8 8 8 8 7 0 0
0 0 7 8 9 9 8 6 6 8 9 9 8 7 0 0
0 0 7 8 8 8 8 6 6 8 8 8 8 7 0 0
0 0 7 7 7 7 7 7 7 7 7 7 7 7 0 0
0 0 0 0 0 0 0 0 0 0 0 0 0 0 0 0
0 0 0 0 0 0 0 0 0 0 0 0 0 0 0 0
 